8 23
+++++++++++++++++++++++
+..................+o.+
+.............+...+..++
+..................+..+
+........+++++++++....+
+.....++++.......+++..+
+...i................++
+++++++++++++++++++++++
